111110000000000000000000011111
111110000000000000000000011111
000000000000000000000000000000
000000000000000000000000000000
000000000000000000000000000000
000000000011111111100000000000
000000000011111111100000000000
000000000011111111100000000000
000000000011111111100000000000
000000000011111111100000000000
000000000011111111100000000000
000000000011111111100000000000
000000000000000000000000000000
000000000000000000000000000000
000000000000000000000000000000
111110000000000000000000011111
111110000000000000000000011111
000000000000000000000000000000
000000000000000000000000000000
000000000000000000000000000000
000000000000000000000000000000
111110000000000000000000011111
111110000000000000000000011111
000000000000000000000000000000
000000000000000000000000000000
000000000000000000000000000000
000000000011111111100000000000
000000000011111111100000000000
000000000000000000000000000000
000000000000000000000000000000
